NO ./textures/enemy.xpm 
SO ./textures/enemy.xpm
WE ./textures/gold.xpm
EA ./textures/wall.xpm

F 0,100,200
C 255,255,255

11111111111
10010000001
10100000001
10010S00001
10000000001
11111111111