NO ./textures/enemy.xpm
SO ./textures/enemy.xpm
WE ./textures/gold.xpm
EA ./textures/wall.xpm

F 0,22,1
C 0,0,0

1111
10N1
1111
1111
