NO ./textures/bri cks.xpm 
SO ./textures/wall.xpm
WE ./textures/enemy.xpm
EA ./textures/wo od.xpm

C 9,105,218
F 255,255,255

1111
10011
11N11
11011
1111