NO ./textures/enemy.xpm 
SO ./textures/enemy.xpm
WE ./textures/gold.xpm
EA ./textures/wall.xpm

C 9,105,218
F 255,255,255

11111111111
10010000001
10100000101
10010S00101
10000001001
11111111111