NO ./textures/bri cks.xpm 
SO ./textures/wall.xpm
WE ./textures/enemy.xpm
EA ./textures/wo od.xpm

C 9,105,218
F 255,255,255

1111
11111
11N11
11111
1111