NO ./textures/bri cks.xpm
SO ./textures/bri cks.xpm
F  0,0,0
WE ./textures/wall.xpm
EA                                    ./textures/wo od.xpm
C 0,5,0

111111111111111
10   0000000001
100000000000001
10000   0000001
10000   0000001
100000000000001
111111111111111
100000000000001
100000000000001
100001000000001
100010000000001
100000000000001
100000000010001
100000S00110001
111111111111111