NO ./textures/enemy.xpm 
F 0,22,1
SO ./textures/enemy.xpm
WE ./textures/gold.xpm
EA ./textures/wall.xpm

C 0,0,0

11111111111
10010000001
10100000001
10010S00001
10000000001
11111111111