NO ./textures/enemy.xpm 
F 0,22,1
SO ./textures/enemy.xpm
WE ./textures/gold.xpm
EA ./textures/wall.xpm

C 0,0,0

111111
1E0101
101001
100101
100101
11111